{
    "test": [
        ["-", "-", "-", "-", "-", "-", "-", "-", "-", "-", "-", "-", "-", "-", "-", "-", "-", "-", "-", "-"],
        ["-", "-", "-", "-", "-", "w", "-", "-", "-", "-", "-", "x", "-", "-", "-", "-", "-", "-", "-", "-"],
        ["-", "x", "x", "-", "-", "-", "-", "-", "-", "-", "-", "-", "-", "-", "-", "x", "-", "x", "-", "-"],
        ["-", "-", "-", "-", "-", "-", "x", "-", "-", "-", "-", "x", "-", "-", "-", "-", "-", "-", "-", "-"],
        ["-", "-", "-", "-", "-", "-", "-", "-", "x", "-", "-", "-", "-", "-", "-", "x", "-", "-", "-", "-"],
        ["-", "-", "x", "-", "x", "-", "-", "-", "-", "-", "-", "-", "-", "-", "-", "-", "-", "w", "-", "-"],
        ["-", "-", "-", "-", "-", "-", "-", "-", "-", "-", "-", "-", "-", "-", "-", "-", "-", "-", "-", "-"],
        ["-", "-", "-", "-", "-", "-", "-", "-", "-", "-", "-", "-", "x", "-", "-", "-", "x", "-", "-", "-"],
        ["-", "-", "-", "-", "-", "-", "-", "x", "-", "-", "-", "-", "-", "-", "-", "-", "-", "-", "-", "-"],
        ["-", "-", "-", "-", "-", "-", "-", "-", "-", "-", "-", "-", "-", "-", "-", "-", "-", "-", "-", "-"],
        ["-", "x", "-", "x", "-", "-", "-", "-", "-", "-", "-", "-", "-", "-", "-", "-", "-", "-", "-", "-"],
        ["-", "-", "-", "-", "-", "-", "-", "x", "-", "-", "-", "x", "-", "-", "-", "-", "-", "x", "-", "-"],
        ["-", "-", "-", "-", "-", "-", "-", "-", "-", "-", "-", "-", "-", "-", "x", "-", "-", "-", "-", "-"],
        ["-", "-", "-", "-", "-", "-", "-", "x", "x", "x", "-", "-", "-", "-", "-", "-", "-", "-", "-", "-"],
        ["-", "-", "-", "-", "-", "-", "-", "-", "-", "-", "-", "-", "-", "-", "-", "-", "-", "-", "-", "-"],
        ["-", "-", "-", "x", "-", "-", "-", "-", "-", "-", "-", "x", "-", "-", "-", "-", "x", "-", "-", "-"],
        ["-", "-", "x", "-", "-", "-", "-", "-", "-", "-", "-", "-", "-", "-", "-", "-", "-", "-", "-", "-"],
        ["-", "-", "-", "-", "-", "-", "-", "-", "-", "-", "-", "-", "-", "-", "x", "-", "-", "-", "-", "-"],
        ["-", "-", "-", "-", "-", "-", "x", "-", "-", "-", "-", "-", "-", "-", "-", "-", "-", "-", "-", "-"],
        ["-", "-", "-", "-", "-", "-", "-", "-", "-", "-", "-", "-", "-", "-", "-", "-", "-", "-", "-", "-"]
    ],
    "level-one": [
        ["-", "-", "-", "-", "-", "-", "-", "-", "-", "-", "-", "-", "-", "-", "-", "-", "-", "-", "-", "-"],
        ["-", "-", "-", "-", "-", "-", "-", "-", "-", "x", "-", "-", "-", "-", "x", "-", "-", "-", "-", "-"],
        ["-", "-", "-", "x", "-", "-", "-", "-", "-", "-", "-", "-", "-", "-", "-", "x", "-", "-", "-", "-"],
        ["-", "x", "-", "-", "-", "-", "-", "-", "-", "-", "-", "-", "-", "-", "-", "-", "-", "-", "-", "-"],
        ["-", "-", "-", "-", "-", "-", "-", "-", "-", "-", "-", "-", "-", "-", "-", "-", "-", "-", "-", "-"],
        ["-", "-", "-", "x", "x", "x", "x", "x", "-", "-", "x", "x", "-", "x", "-", "-", "x", "x", "x", "x"],
        ["-", "-", "-", "-", "-", "-", "-", "x", "-", "-", "x", "-", "-", "x", "-", "-", "-", "-", "-", "-"],
        ["-", "-", "-", "-", "-", "-", "-", "x", "-", "-", "-", "-", "-", "x", "-", "-", "-", "-", "-", "-"],
        ["-", "-", "-", "-", "-", "-", "-", "x", "x", "-", "-", "-", "-", "x", "-", "-", "-", "-", "-", "-"],
        ["-", "x", "x", "x", "-", "-", "-", "x", "-", "-", "-", "-", "-", "x", "x", "x", "-", "-", "-", "-"],
        ["-", "-", "-", "-", "-", "-", "-", "x", "-", "-", "w", "-", "-", "x", "-", "-", "-", "-", "-", "-"],
        ["-", "-", "-", "-", "-", "-", "-", "x", "-", "-", "-", "-", "-", "x", "-", "-", "-", "-", "-", "-"],
        ["-", "-", "-", "-", "-", "-", "-", "x", "x", "x", "x", "x", "x", "x", "-", "-", "-", "-", "-", "-"],
        ["-", "-", "-", "-", "-", "-", "-", "-", "-", "-", "-", "-", "-", "-", "-", "-", "-", "-", "-", "-"],
        ["x", "x", "x", "x", "x", "x", "x", "-", "-", "-", "-", "-", "-", "-", "x", "x", "x", "x", "x", "x"],
        ["-", "-", "-", "-", "-", "-", "-", "-", "-", "-", "-", "-", "-", "-", "-", "-", "-", "-", "-", "-"],
        ["-", "x", "-", "-", "-", "-", "-", "-", "-", "-", "-", "-", "-", "-", "-", "-", "-", "-", "-", "-"],
        ["-", "-", "-", "-", "-", "x", "-", "-", "-", "-", "-", "-", "-", "x", "-", "-", "-", "-", "-", "-"],
        ["-", "-", "-", "-", "-", "-", "-", "-", "-", "-", "-", "-", "-", "-", "-", "-", "-", "-", "-", "-"],
        ["-", "-", "-", "-", "-", "-", "-", "-", "-", "-", "-", "-", "-", "-", "-", "-", "-", "-", "-", "-"]
    ],
    "level-two": [
        ["-", "-", "-", "-", "-", "-", "-", "-", "-", "-", "-", "-", "-", "-", "-", "-", "-", "-", "-", "-"],
        ["-", "-", "-", "-", "-", "-", "-", "-", "-", "-", "-", "-", "-", "-", "-", "-", "-", "-", "-", "-"],
        ["-", "-", "-", "-", "-", "-", "-", "-", "-", "-", "-", "-", "-", "-", "-", "-", "-", "-", "-", "-"],
        ["-", "-", "-", "-", "x", "x", "x", "x", "x", "x", "x", "x", "x", "x", "x", "x", "x", "x", "x", "x"],
        ["-", "-", "-", "-", "x", "-", "-", "-", "-", "-", "-", "-", "-", "-", "-", "-", "-", "-", "-", "-"],
        ["-", "-", "-", "-", "x", "-", "-", "-", "-", "-", "-", "-", "-", "-", "-", "-", "-", "-", "-", "-"],
        ["-", "-", "x", "-", "x", "-", "-", "-", "-", "-", "-", "-", "-", "-", "x", "x", "x", "x", "-", "-"],
        ["-", "-", "-", "-", "x", "-", "-", "-", "-", "-", "-", "-", "-", "-", "x", "-", "-", "-", "-", "-"],
        ["-", "-", "-", "-", "x", "-", "-", "-", "-", "-", "-", "-", "-", "-", "x", "-", "-", "-", "-", "-"],
        ["-", "x", "-", "-", "x", "-", "-", "-", "x", "x", "x", "x", "x", "x", "x", "-", "-", "-", "-", "-"],
        ["-", "-", "-", "-", "x", "-", "-", "-", "x", "-", "-", "-", "-", "-", "x", "-", "-", "-", "-", "-"],
        ["-", "-", "x", "-", "x", "-", "-", "-", "x", "-", "-", "-", "-", "-", "x", "-", "-", "x", "x", "x"],
        ["-", "-", "-", "-", "x", "-", "-", "-", "x", "-", "w", "-", "-", "-", "x", "-", "-", "-", "-", "-"],
        ["-", "-", "-", "-", "x", "-", "-", "-", "x", "x", "x", "-", "-", "-", "x", "-", "-", "-", "-", "-"],
        ["-", "-", "-", "-", "x", "-", "-", "-", "-", "-", "x", "-", "-", "-", "-", "x", "x", "x", "-", "-"],
        ["-", "-", "-", "-", "x", "-", "-", "-", "-", "-", "-", "x", "-", "-", "-", "-", "-", "-", "-", "-"],
        ["-", "-", "-", "-", "-", "-", "-", "-", "-", "-", "-", "-", "x", "-", "-", "-", "-", "-", "-", "-"],
        ["-", "x", "-", "-", "-", "-", "-", "-", "-", "-", "-", "-", "-", "x", "-", "-", "-", "-", "-", "-"],
        ["-", "-", "-", "-", "-", "-", "-", "-", "-", "-", "-", "-", "-", "-", "x", "x", "x", "x", "x", "x"],
        ["-", "-", "-", "-", "-", "-", "-", "-", "-", "-", "-", "-", "-", "-", "-", "-", "-", "-", "-", "-"]
    ],
    "level-three": [
        ["-", "-", "-", "-", "-", "-", "-", "-", "-", "-", "-", "-", "-", "-", "-", "-", "-", "-", "-", "-"],
        ["-", "-", "-", "-", "-", "-", "-", "-", "-", "-", "-", "-", "-", "-", "-", "-", "-", "-", "-", "-"],
        ["-", "-", "-", "-", "x", "x", "x", "x", "x", "x", "x", "-", "-", "-", "-", "-", "-", "-", "-", "-"],
        ["-", "-", "-", "-", "x", "-", "-", "-", "-", "-", "x", "-", "x", "x", "x", "x", "x", "x", "-", "-"],
        ["-", "-", "x", "-", "x", "-", "-", "x", "-", "-", "x", "-", "x", "-", "-", "-", "-", "x", "-", "-"],
        ["-", "-", "-", "-", "x", "-", "-", "x", "-", "-", "x", "-", "x", "-", "-", "w", "-", "x", "-", "-"],
        ["-", "x", "-", "-", "x", "-", "-", "x", "-", "-", "x", "-", "x", "-", "-", "x", "x", "x", "-", "-"],
        ["-", "-", "-", "-", "x", "-", "-", "x", "-", "-", "x", "-", "x", "-", "-", "x", "-", "-", "-", "-"],
        ["-", "-", "-", "-", "x", "-", "-", "x", "-", "-", "x", "-", "x", "-", "-", "x", "-", "-", "-", "-"],
        ["-", "x", "-", "-", "x", "-", "-", "x", "-", "-", "x", "-", "x", "-", "-", "x", "-", "-", "-", "-"],
        ["-", "-", "-", "-", "x", "-", "-", "x", "-", "-", "x", "-", "x", "-", "-", "x", "-", "x", "-", "-"],
        ["-", "-", "-", "x", "-", "-", "-", "x", "-", "-", "-", "x", "x", "-", "-", "x", "-", "-", "-", "-"],
        ["-", "-", "x", "-", "-", "-", "x", "-", "x", "-", "-", "-", "-", "-", "-", "x", "-", "-", "-", "-"],
        ["-", "-", "x", "-", "-", "x", "-", "-", "-", "x", "-", "-", "-", "-", "-", "x", "-", "-", "x", "-"],
        ["-", "-", "-", "-", "-", "-", "-", "-", "-", "-", "x", "x", "x", "x", "x", "x", "-", "-", "-", "-"],
        ["-", "-", "-", "-", "x", "-", "-", "-", "-", "-", "-", "-", "-", "-", "-", "-", "-", "-", "-", "-"],
        ["-", "x", "-", "-", "-", "-", "-", "-", "-", "-", "-", "-", "x", "-", "-", "-", "-", "-", "-", "-"],
        ["-", "-", "-", "-", "-", "-", "x", "-", "-", "-", "-", "-", "-", "-", "-", "-", "-", "-", "-", "-"],
        ["-", "-", "-", "-", "-", "-", "-", "-", "-", "-", "-", "-", "-", "-", "-", "-", "-", "-", "-", "-"],
        ["-", "-", "-", "-", "-", "-", "-", "-", "-", "-", "-", "-", "-", "-", "-", "-", "-", "-", "-", "-"]
    ]
}