{
    "test": [
        ["-", "-", "-", "-", "-", "-", "-", "-", "-", "-", "-", "-", "-", "-", "-", "-", "-", "-", "-", "-"],
        ["-", "-", "-", "-", "-", "w", "-", "-", "-", "-", "-", "x", "-", "-", "-", "-", "-", "-", "-", "-"],
        ["-", "x", "x", "-", "-", "-", "-", "-", "-", "-", "-", "-", "-", "-", "-", "x", "-", "x", "-", "-"],
        ["-", "-", "-", "-", "-", "-", "x", "-", "-", "-", "-", "x", "-", "-", "-", "-", "-", "-", "-", "-"],
        ["-", "-", "-", "-", "-", "-", "-", "-", "x", "-", "-", "-", "-", "-", "-", "x", "-", "-", "-", "-"],
        ["-", "-", "x", "-", "x", "-", "-", "-", "-", "-", "-", "-", "-", "-", "-", "-", "-", "-", "-", "-"],
        ["-", "-", "-", "-", "-", "-", "-", "-", "-", "-", "-", "-", "-", "-", "-", "-", "-", "-", "-", "-"],
        ["-", "-", "-", "-", "-", "-", "-", "-", "-", "-", "-", "-", "x", "-", "-", "-", "x", "-", "-", "-"],
        ["-", "-", "-", "-", "-", "-", "-", "x", "-", "-", "-", "-", "-", "-", "-", "-", "-", "-", "-", "-"],
        ["-", "-", "-", "-", "-", "-", "-", "-", "-", "-", "-", "-", "-", "-", "-", "-", "-", "-", "-", "-"],
        ["-", "x", "-", "x", "-", "-", "-", "-", "-", "-", "-", "-", "-", "-", "-", "-", "-", "-", "-", "-"],
        ["-", "-", "-", "-", "-", "-", "-", "x", "-", "-", "-", "x", "-", "-", "-", "-", "-", "x", "-", "-"],
        ["-", "-", "-", "-", "-", "-", "-", "-", "-", "-", "-", "-", "-", "-", "x", "-", "-", "-", "-", "-"],
        ["-", "-", "-", "-", "-", "-", "-", "x", "x", "x", "-", "-", "-", "-", "-", "-", "-", "-", "-", "-"],
        ["-", "-", "-", "-", "-", "-", "-", "-", "-", "-", "-", "-", "-", "-", "-", "-", "-", "-", "-", "-"],
        ["-", "-", "-", "x", "-", "-", "-", "-", "-", "-", "-", "x", "-", "-", "-", "-", "x", "-", "-", "-"],
        ["-", "-", "x", "-", "-", "-", "-", "-", "-", "-", "-", "-", "-", "-", "-", "-", "-", "-", "-", "-"],
        ["-", "-", "-", "-", "-", "-", "-", "-", "-", "-", "-", "-", "-", "-", "x", "-", "-", "-", "-", "-"],
        ["-", "-", "-", "-", "-", "-", "x", "-", "-", "-", "-", "-", "-", "-", "-", "-", "-", "-", "-", "-"],
        ["-", "-", "-", "-", "-", "-", "-", "-", "-", "-", "-", "-", "-", "-", "-", "-", "-", "-", "-", "-"]
    ]
}