{
	"level-three": [
        ["-", "-", "-", "-", "-", "-", "-", "-", "-", "-", "-", "-", "-", "-", "-", "-", "-", "-", "-", "-"],
        ["-", "-", "-", "-", "-", "-", "-", "-", "-", "-", "-", "-", "-", "-", "-", "-", "-", "-", "-", "-"],
        ["-", "-", "-", "-", "x", "x", "x", "x", "x", "x", "x", "-", "-", "-", "-", "-", "-", "-", "-", "-"],
        ["-", "-", "-", "-", "x", "-", "-", "-", "-", "-", "x", "-", "x", "x", "x", "x", "x", "x", "-", "-"],
        ["-", "-", "x", "-", "x", "-", "-", "x", "-", "-", "x", "-", "x", "-", "-", "-", "-", "x", "-", "-"],
        ["-", "-", "-", "-", "x", "-", "-", "x", "-", "-", "x", "-", "x", "-", "-", "w", "-", "x", "-", "-"],
        ["-", "x", "-", "-", "x", "-", "-", "x", "-", "-", "x", "-", "x", "-", "-", "x", "x", "x", "-", "-"],
        ["-", "-", "-", "-", "x", "-", "-", "x", "-", "-", "x", "-", "x", "-", "-", "x", "-", "-", "-", "-"],
        ["-", "-", "-", "-", "x", "-", "-", "x", "-", "-", "x", "-", "x", "-", "-", "x", "-", "-", "-", "-"],
        ["-", "x", "-", "-", "x", "-", "-", "x", "-", "-", "x", "-", "x", "-", "-", "x", "-", "-", "-", "-"],
        ["-", "-", "-", "-", "x", "-", "-", "x", "-", "-", "x", "-", "x", "-", "-", "x", "-", "x", "-", "-"],
        ["-", "-", "-", "x", "-", "-", "-", "x", "-", "-", "-", "x", "x", "-", "-", "x", "-", "-", "-", "-"],
        ["-", "-", "x", "-", "-", "-", "x", "-", "x", "-", "-", "-", "-", "-", "-", "x", "-", "-", "-", "-"],
        ["-", "-", "x", "-", "-", "x", "-", "-", "-", "x", "-", "-", "-", "-", "-", "x", "-", "-", "x", "-"],
        ["-", "-", "-", "-", "-", "-", "-", "-", "-", "-", "x", "x", "x", "x", "x", "x", "-", "-", "-", "-"],
        ["-", "-", "-", "-", "x", "-", "-", "-", "-", "-", "-", "-", "-", "-", "-", "-", "-", "-", "-", "-"],
        ["-", "x", "-", "-", "-", "-", "-", "-", "-", "-", "-", "-", "x", "-", "-", "-", "-", "-", "-", "-"],
        ["-", "-", "-", "-", "-", "-", "x", "-", "-", "-", "-", "-", "-", "-", "-", "-", "-", "-", "-", "-"],
        ["-", "-", "-", "-", "-", "-", "-", "-", "-", "-", "-", "-", "-", "-", "-", "-", "-", "-", "-", "-"],
        ["-", "-", "-", "-", "-", "-", "-", "-", "-", "-", "-", "-", "-", "-", "-", "-", "-", "-", "-", "-"]
    ]
}