{
    "level-one": [
        ["-", "-", "-", "-", "-", "-", "-", "-", "-", "-", "-", "-", "-", "-", "-", "-", "-", "-", "-", "-"],
        ["-", "-", "-", "-", "-", "-", "-", "-", "-", "x", "-", "-", "-", "-", "x", "-", "-", "-", "-", "-"],
        ["-", "-", "-", "x", "-", "-", "-", "-", "-", "-", "-", "-", "-", "-", "-", "x", "-", "-", "-", "-"],
        ["-", "x", "-", "-", "-", "-", "-", "-", "-", "-", "-", "-", "-", "-", "-", "-", "-", "-", "-", "-"],
        ["-", "-", "-", "-", "-", "-", "-", "-", "-", "-", "-", "-", "-", "-", "-", "-", "-", "-", "-", "-"],
        ["-", "-", "-", "x", "x", "x", "x", "x", "-", "-", "x", "x", "-", "x", "-", "-", "x", "x", "x", "x"],
        ["-", "-", "-", "-", "-", "-", "-", "x", "-", "-", "x", "-", "-", "x", "-", "-", "-", "-", "-", "-"],
        ["-", "-", "-", "-", "-", "-", "-", "x", "-", "-", "-", "-", "-", "x", "-", "-", "-", "-", "-", "-"],
        ["-", "-", "-", "-", "-", "-", "-", "x", "x", "-", "-", "-", "-", "x", "-", "-", "-", "-", "-", "-"],
        ["-", "x", "x", "x", "-", "-", "-", "x", "-", "-", "-", "-", "-", "x", "x", "x", "-", "-", "-", "-"],
        ["-", "-", "-", "-", "-", "-", "-", "x", "-", "-", "w", "-", "-", "x", "-", "-", "-", "-", "-", "-"],
        ["-", "-", "-", "-", "-", "-", "-", "x", "-", "-", "-", "-", "-", "x", "-", "-", "-", "-", "-", "-"],
        ["-", "-", "-", "-", "-", "-", "-", "x", "x", "x", "x", "x", "x", "x", "-", "-", "-", "-", "-", "-"],
        ["-", "-", "-", "-", "-", "-", "-", "-", "-", "-", "-", "-", "-", "-", "-", "-", "-", "-", "-", "-"],
        ["x", "x", "x", "x", "x", "x", "x", "-", "-", "-", "-", "-", "-", "-", "x", "x", "x", "x", "x", "x"],
        ["-", "-", "-", "-", "-", "-", "-", "-", "-", "-", "-", "-", "-", "-", "-", "-", "-", "-", "-", "-"],
        ["-", "x", "-", "-", "-", "-", "-", "-", "-", "-", "-", "-", "-", "-", "-", "-", "-", "-", "-", "-"],
        ["-", "-", "-", "-", "-", "x", "-", "-", "-", "-", "-", "-", "-", "x", "-", "-", "-", "-", "-", "-"],
        ["-", "-", "-", "-", "-", "-", "-", "-", "-", "-", "-", "-", "-", "-", "-", "-", "-", "-", "-", "-"],
        ["-", "-", "-", "-", "-", "-", "-", "-", "-", "-", "-", "-", "-", "-", "-", "-", "-", "-", "-", "-"]
    ]
}